Floyd Pherps	,president
Carling Adacot	,president
Arluene Gatty	,president
Abed Nadhir  ,president
Nelie Siburn	,GSUOfficer
Ferd Dorbon	,GSUOfficer
Massimo Corradini	,GSUOfficer
Filberte Espinay	,GSUOfficer
Aretha Giorio	,BSOfficer
Verne Bernon	,BSOfficer
Klemens Gremain	,BSOfficer
Ross Bernardotte	,BSOfficer
Berkeley Elkington	,FEHOfficer
Cheslie Gareisr	,FEHOfficer
Nobe Jurisch	,FEHOfficer
Tiffany Yesenin	,FEHOfficer
Rayna MacDonogh	,FACHOfficer
Karry Arnefield	,FACHOfficer
Randolph Witterick	,FACHOfficer
Bevan Shirley	,FACHOfficer
Faith Hillburn	,FESOfficer
Malinda Cluley	,FESOfficer
Angel Meehan	,FESOfficer
Greta Dewdney	,FESOfficer